

NO    ./texture_files/wall_1.png
WE  ./texture_files/wall_2.png
EA   		./texture_files/wall_3.png
SO  ./texture_files/wall_4.png

F 194,147,96
C 116,150,220

         11111111111111111111111111111
         10000000001100000000000000001
         10110000011100000001111111111
11111111110000000000000000011111
        101100000111000000001111111
11111111100110000011101111011
11110111111111011100000010001
11110111111111011101010010001
11000000110011011100000010001
10000000000000001100000010001
10000000000000001100010000001
10000000000000001100010000001
10000000000000001100010000001
10000000000000001100010000001
10000000000000000000000000001
11000000110110000000000000001
11110111110110000000000000001
10000000111110000100000010001
10000000000000000000000001001
10000000111100010000N00001001
100000001  100110101110000001
10000000111110000001 10100001
11111111111111111111 11111111
