F 153,217,255
C 76,170,23


NO    ./texture_files/n.png
WE  ./texture_files/w.png
EA  ./texture_files/e.png
SO  ./texture_files/s.png



1111111111111111111111111111111
1000000000000000000000000000001
1001111111100001111111111110001
1001111111100001111111111110001
1001110000000000000111100000001
1001110000000000000111100000001
1001111111100000000111100000001
100111111110000N000111100000001
1000000000000000000000000000001
1111111111111111111111111111111