C 153,217,255
F 26,100,3


NO    ./texture_files/n.png
WE  ./texture_files/w.png
EA   		./texture_files/e.png
SO  ./texture_files/s.png


        1111111111111111111111111
        1000000000110000000000001
        1011000001110000001000001
        1001000000000000000000001
111111111011000001110000000000001
100000000011000001110111111111111
11110111111111011100000010001
11110111111111011101010010001
11000000110111011100000010001
10000000000000001100000010001
100000000000N0001101010010001
110000011101010111110111100111
11110111 1110101 101111010001
11111111 1111111 111111111111