F 153,217,255
C 76,170,23


NO    ./texture_files/n.png
WE  ./texture_files/w.png
EA  ./texture_files/e.png
SO  ./texture_files/s.png


11111111111111111111
10000000000000000001
1000000000N000000001
10000000000000000001
10000000000000000001
10000000000000000001
11110000000000111111
11110001111100111111
10000111   100000001
11111111   111111111