F 234,0,255
C 255,255,255


NO    ./textures/n.png
WE  ./textures/w.png
EA  ./textures/e.png
SO  ./textures/s.png

   11111111111111111111
   10000000100000000001
10110000000100000001111
1000000000N000000001
10000000000000000001
10000000000000000001
11111111111111111111